BF_brain1	/ifs5/PC_PA_UN/ANIMAL/PMO/GROUP2/Hgla/Transcriptome/2.alignment/BF_brain1/accepted_hits.bam
BF_brain2	/ifs5/PC_PA_UN/ANIMAL/PMO/GROUP2/Hgla/Transcriptome/2.alignment/BF_brain2/accepted_hits.bam
BF_brain3	/ifs5/PC_PA_UN/ANIMAL/PMO/GROUP2/Hgla/Transcriptome/2.alignment/BF_brain3/accepted_hits.bam
BF_ovary1	/ifs5/PC_PA_UN/ANIMAL/PMO/GROUP2/Hgla/Transcriptome/2.alignment/BF_ovary1/accepted_hits.bam
BF_ovary2	/ifs5/PC_PA_UN/ANIMAL/PMO/GROUP2/Hgla/Transcriptome/2.alignment/BF_ovary2/accepted_hits.bam
BF_ovary3	/ifs5/PC_PA_UN/ANIMAL/PMO/GROUP2/Hgla/Transcriptome/2.alignment/BF_ovary3/accepted_hits.bam
BM_brain1	/ifs5/PC_PA_UN/ANIMAL/PMO/GROUP2/Hgla/Transcriptome/2.alignment/BM_brain1/accepted_hits.bam
BM_brain2	/ifs5/PC_PA_UN/ANIMAL/PMO/GROUP2/Hgla/Transcriptome/2.alignment/BM_brain2/accepted_hits.bam
BM_brain3	/ifs5/PC_PA_UN/ANIMAL/PMO/GROUP2/Hgla/Transcriptome/2.alignment/BM_brain3/accepted_hits.bam
BM_testis1	/ifs5/PC_PA_UN/ANIMAL/PMO/GROUP2/Hgla/Transcriptome/2.alignment/BM_testis1/accepted_hits.bam
BM_testis2	/ifs5/PC_PA_UN/ANIMAL/PMO/GROUP2/Hgla/Transcriptome/2.alignment/BM_testis2/accepted_hits.bam
BM_testis3	/ifs5/PC_PA_UN/ANIMAL/PMO/GROUP2/Hgla/Transcriptome/2.alignment/BM_testis3/accepted_hits.bam
PBF_brain1	/ifs5/PC_PA_UN/ANIMAL/PMO/GROUP2/Hgla/Transcriptome/2.alignment/PBF_brain1/accepted_hits.bam
PBF_brain2	/ifs5/PC_PA_UN/ANIMAL/PMO/GROUP2/Hgla/Transcriptome/2.alignment/PBF_brain2/accepted_hits.bam
PBF_brain3	/ifs5/PC_PA_UN/ANIMAL/PMO/GROUP2/Hgla/Transcriptome/2.alignment/PBF_brain3/accepted_hits.bam
PBF_ovary1	/ifs5/PC_PA_UN/ANIMAL/PMO/GROUP2/Hgla/Transcriptome/2.alignment/PBF_ovary1/accepted_hits.bam
PBF_ovary2	/ifs5/PC_PA_UN/ANIMAL/PMO/GROUP2/Hgla/Transcriptome/2.alignment/PBF_ovary2/accepted_hits.bam
PBF_ovary3	/ifs5/PC_PA_UN/ANIMAL/PMO/GROUP2/Hgla/Transcriptome/2.alignment/PBF_ovary3/accepted_hits.bam
WF_brain1	/ifs5/PC_PA_UN/ANIMAL/PMO/GROUP2/Hgla/Transcriptome/2.alignment/WF_brain1/accepted_hits.bam
WF_brain2	/ifs5/PC_PA_UN/ANIMAL/PMO/GROUP2/Hgla/Transcriptome/2.alignment/WF_brain2/accepted_hits.bam
WF_brain3	/ifs5/PC_PA_UN/ANIMAL/PMO/GROUP2/Hgla/Transcriptome/2.alignment/WF_brain3/accepted_hits.bam
WF_ovary1	/ifs5/PC_PA_UN/ANIMAL/PMO/GROUP2/Hgla/Transcriptome/2.alignment/WF_ovary1/accepted_hits.bam
WF_ovary2	/ifs5/PC_PA_UN/ANIMAL/PMO/GROUP2/Hgla/Transcriptome/2.alignment/WF_ovary2/accepted_hits.bam
WM_brain1	/ifs5/PC_PA_UN/ANIMAL/PMO/GROUP2/Hgla/Transcriptome/2.alignment/WM_brain1/accepted_hits.bam
WM_brain2	/ifs5/PC_PA_UN/ANIMAL/PMO/GROUP2/Hgla/Transcriptome/2.alignment/WM_brain2/accepted_hits.bam
WM_brain3	/ifs5/PC_PA_UN/ANIMAL/PMO/GROUP2/Hgla/Transcriptome/2.alignment/WM_brain3/accepted_hits.bam
WM_testis1	/ifs5/PC_PA_UN/ANIMAL/PMO/GROUP2/Hgla/Transcriptome/2.alignment/WM_testis1/accepted_hits.bam
WM_testis2	/ifs5/PC_PA_UN/ANIMAL/PMO/GROUP2/Hgla/Transcriptome/2.alignment/WM_testis2/accepted_hits.bam
WM_testis3	/ifs5/PC_PA_UN/ANIMAL/PMO/GROUP2/Hgla/Transcriptome/2.alignment/WM_testis3/accepted_hits.bam
